"a" = (/turf/floor,/area)
"b" = (/turf/wall,/area)
"c" = (/obj/light{tag = "icon-light (NORTH)"; icon_state = "light"; dir = 1},/turf/floor,/area)
"d" = (/obj/light{tag = "icon-light (WEST)"; icon_state = "light"; dir = 8},/turf/floor,/area)
"e" = (/obj/light{tag = "icon-light (EAST)"; icon_state = "light"; dir = 4},/turf/floor,/area)
"f" = (/obj/light,/turf/floor,/area)
"g" = (/obj/door{tag = "icon-open_door"; icon_state = "open_door"},/turf/floor,/area)
"h" = (/obj/panel,/turf/wall,/area)
"i" = (/turf/floor/elevator,/area)
"j" = (/obj/door/elevator,/turf/floor/elevator,/area)
"k" = (/obj/door,/turf/floor,/area)
"l" = (/turf/nicewall{tag = "icon-nicewall (SOUTHEAST)"; icon_state = "nicewall"; dir = 6},/area)
"m" = (/turf/nicewall,/area)
"n" = (/obj/door{tag = "icon-nicedoor"; icon_state = "nicedoor"},/turf/floor,/area)
"o" = (/turf/nicewall{tag = "icon-nicewall (SOUTHWEST)"; icon_state = "nicewall"; dir = 10},/area)
"p" = (/turf/nicewall{tag = "icon-nicewall (EAST)"; icon_state = "nicewall"; dir = 4},/area)
"q" = (/turf/nicewall{tag = "icon-nicewall (WEST)"; icon_state = "nicewall"; dir = 8},/area)
"r" = (/mob,/turf/floor,/area)
"s" = (/mob{icon_state = "blue"},/turf/floor,/area)
"t" = (/turf/nicewall{tag = "icon-nicewall (NORTHEAST)"; icon_state = "nicewall"; dir = 5},/area)
"u" = (/turf/nicewall{tag = "icon-nicewall (NORTH)"; icon_state = "nicewall"; dir = 1},/area)
"v" = (/turf/nicewall{tag = "icon-nicewall (NORTHWEST)"; icon_state = "nicewall"; dir = 9},/area)

(1,1,1) = {"
aaaaaaaaaaaaaaaaaaaaaaaaaaaaaaaaaaaaaaaa
aaaaaaaaaaaaaaaaaaaaaaaaaaaaaaaaaaaaaaaa
aaaaaaaaaaaaaaaaaaaaaaaaaaaaaaaaaaaaaaaa
aaaaaaaaaaaaaaaaaaaaaaaaaaaaaaaaaaaaaaaa
aaaaaaaaaaaaaaaaaaaaaaaaaaaaaaaaaaaaaaaa
aaaaaaaaaaaaaaaaaaaaaaaaaaaaaaaaaaaaaaaa
aaaaaaaaaaaaaaaaaaaaaaaaaaaaaaaaaaaaaaaa
aaaaaaaaaaaaaaaaaaaaaaaaaaaaaaaaaaaaaaaa
aaaaaaaaaaaaaaaaaaaaaaaaaaaaaaaaaaaaaaaa
aaaaaaaaaaaaaaaaaaaaaaaaaaaaaaaaaaaaaaaa
aaaaaaaaaaaaaaaaaaaaaaaaaaaaaaaaaaaaaaaa
aaaaaaaaaaaaaaaaaaaaaaaaaaaaaaaaaaaaaaaa
aaaaaaaaaaaaaaaaaaaaaaaaaaaaaaaaaaaaaaaa
aaaaaaaaaaaaaaaaaaaaaaaaaaaaaaaaaaaaaaaa
aaaaaaaaaaaaaaaaaaaaaaaaaaaaaaaaaaaaaaaa
aaaaaaaaaaaaaaaaaaaaaaaaaaaaaaaaaaaaaaaa
aaaaaaaaaaaaaaaaaaaaaaaaaaaaaaaaaaaaaaaa
aaaaaaaaaaaaaaaaaaaaaaaaaaaaaaaaaaaaaaaa
aaaaaaaaaaaaaaaaaaaaaaaaaaaaaaaaaaaaaaaa
aaaaaaaaaaaaaaaaaaaaaaaaaaaaaaaaaaaaaaaa
bbbbbbbbbbbbbbbbbbbbaaaaaaaaaaaaaaaaaaaa
baaaaaaaacaaaaaaaaabaaaaaaaaaaaaaaaaaaaa
baaaaaaaaaaaaaaaaaabaaaaaaaaaaaaaaaaaaaa
baaaaaaaaaaaaaaaaaabaaaaaaaaaaaaaaaaaaaa
bdaaaaaaaaaaaaaaaaebaaaaaaaaaaaaaaaaaaaa
baaaaaaaaaaaaaaaaaabaaaaaaaaaaaaaaaaaaaa
baaaaaaaafaaaaaaaaabaaaaaaaaaaaaaaaaaaaa
bbbbbbbbbbgbbbbbbbbbbbbbbbbbbbbbaaaaaaaa
baaaaacaaaaacaaaaaacaaaaaachiiibaaaaaaaa
baaaaaaaaaaaaaaaaaaaaaaaaaajiiibaaaaaaaa
baaaaafaaaaafaaaaaafaaaaaafbiiibaaaaaaaa
bbbbkbbblmmmmmnmmmmobbbbbbbbbbbbaaaaaaaa
baaaaaaapaaacaaacaaqaaaaaaaaaaaaaaaaaaaa
bdaaaaaepaaaaaaaaaaqaaaaaaaaaaaaaaaaaaaa
baaaaaaapaaaaaaaaaaqaaaaaaaaaaaaaaaaaaaa
baaaaaaaparaaaaaasaqaaaaaaaaaaaaaaaaaaaa
baaaaaaapaaaaaaaaaaqaaaaaaaaaaaaaaaaaaaa
bdaaaaaepaaaaaaaaaaqaaaaaaaaaaaaaaaaaaaa
baaaaaaapaaafaaafaaqaaaaaaaaaaaaaaaaaaaa
bbbbbbbbtuuuuuuuuuuvaaaaaaaaaaaaaaaaaaaa
"}
